80 60 1000
265 3 595 377 114 710 829 218 534 451 72 519 752 694 356 117 177 372 243 800 600 173 227 795 187 852 694 84 434 92 394 429 571 456 83 132 863 949 348 641 897 637 363 599 872 630 666 60 1000 711 115 723 10 257 739 125 179 455 619 902 252 837 327 517 150 456 581 950 830 318 291 864 12 930 990 835 614 480 411 803
214 456 712 510 867 363 951 817 520 922 104 239 271 460 829 631 372 436 218 226 874 826 314 382 346 395 686 791 341 997 836 864 649 107 899 421 190 650 20 116 57 306 61 31 283 698 632 458 654 320 430 30 286 708 290 284 584 353 439 891 570 729 612 299 301 610 88 631 376 624 666 264 861 135 958 328 158 240 636 270
661 622 443 447 302 714 488 956 815 112 566 880 276 412 180 45 841 770 531 427 855 842 321 382 867 329 194 524 541 26 806 39 289 821 204 28 14 670 624 59 975 534 665 494 992 101 987 808 674 382 934 966 19 960 743 733 465 178 85 500 397 984 49 214 500 564 330 6 8 921 949 519 693 871 443 63 308 101 564 648
923 446 292 529 359 683 646 58 823 102 146 186 537 54 628 984 354 904 179 460 700 441 41 600 214 150 281 986 74 72 15 692 174 877 694 396 776 699 394 401 506 171 819 865 879 249 80 23 104 940 521 154 73 670 562 314 376 970 442 590 55 0 113 554 270 965 662 691 328 939 917 625 266 813 613 379 579 760 15 912
966 69 873 288 872 800 31 408 741 339 536 936 125 114 695 771 515 701 800 998 398 653 291 698 317 115 666 240 103 383 804 827 723 224 278 388 22 682 901 677 551 135 62 670 733 914 687 896 667 89 597 36 692 840 684 631 511 997 814 100 436 788 793 247 899 834 401 376 15 627 222 980 41 523 567 725 234 473 371 542
609 784 371 652 845 616 770 490 809 958 558 483 118 623 292 297 898 51 394 180 598 941 360 797 497 532 625 229 673 318 466 682 328 48 638 108 497 961 758 209 139 540 582 576 644 335 476 24 116 65 412 323 870 945 609 690 802 237 348 49 735 88 837 191 780 535 793 604 448 62 708 68 745 0 484 140 809 231 825 966
69 836 901 85 904 111 517 425 144 968 691 728 305 85 390 775 683 219 566 664 687 551 535 16 41 604 32 828 125 340 114 605 497 294 341 882 234 489 427 727 665 112 488 559 487 248 120 275 507 855 87 978 886 394 535 477 440 190 788 396 485 641 454 309 576 796 808 331 610 345 745 446 616 61 688 16 614 291 352 822
919 669 115 185 69 408 291 903 600 780 499 428 225 775 600 288 981 588 168 520 360 633 721 516 489 61 464 982 355 499 843 529 851 314 147 483 217 160 945 804 923 108 765 428 550 392 587 703 442 586 259 770 999 985 620 483 904 974 381 818 882 269 173 414 711 752 212 363 973 12 775 36 853 76 291 728 707 742 402 706
722 670 770 17 902 510 487 784 806 270 343 875 324 960 369 806 952 181 442 166 263 286 112 524 459 335 592 192 247 316 764 600 424 791 313 729 508 711 618 638 567 845 841 198 72 695 231 524 200 240 767 56 879 173 164 797 877 358 172 227 892 572 261 496 827 41 343 508 790 653 45 520 239 707 134 770 185 575 765 874
247 192 941 328 350 599 220 147 235 737 769 661 662 195 103 492 729 661 622 248 70 416 795 645 124 551 620 452 36 483 237 975 576 838 132 601 283 922 928 296 874 641 76 607 525 321 251 223 6 605 160 79 908 246 631 313 985 780 16 722 247 381 77 793 870 262 843 449 872 534 645 433 616 35 687 861 954 806 300 414
811 57 933 812 333 640 633 756 672 859 911 919 492 534 546 914 32 251 946 832 231 280 487 140 666 800 263 73 669 638 824 202 155 716 762 736 223 165 479 955 359 202 738 543 332 771 372 10 990 341 18 574 852 818 703 372 977 340 345 482 413 841 779 216 905 555 563 22 974 927 613 169 96 633 191 671 496 239 862 607
817 271 267 319 275 56 255 519 673 913 331 964 811 877 523 27 692 590 358 644 814 214 766 359 275 728 208 758 416 586 415 55 437 776 620 804 895 51 348 233 407 414 753 841 597 882 482 223 727 827 710 862 716 594 5 605 633 870 637 715 976 771 915 375 954 852 626 283 826 42 48 478 74 625 676 957 624 336 5 673
15 902 731 154 341 979 489 885 399 54 796 982 859 346 272 994 994 613 512 477 644 679 793 776 32 499 493 505 17 103 774 338 63 194 258 343 16 443 630 214 351 224 360 411 655 295 853 865 879 393 840 801 977 873 429 559 87 5 396 166 328 330 929 192 57 873 216 587 153 183 350 835 235 92 79 672 840 505 813 940
150 652 280 317 319 297 25 825 361 544 426 97 43 580 676 232 693 124 929 12 159 42 678 845 448 139 150 763 592 381 131 529 854 634 750 747 437 620 168 781 22 464 819 498 665 272 5 816 225 106 61 150 732 139 427 946 692 120 575 279 102 86 154 161 185 296 968 786 862 143 991 761 644 802 446 354 242 498 76 209
37 647 564 375 502 135 586 489 153 227 385 780 582 175 740 257 444 116 990 454 42 818 415 818 751 112 322 7 527 354 931 385 529 343 811 404 279 582 918 57 523 844 792 374 673 241 536 490 840 49 881 841 930 261 756 121 970 710 362 305 312 768 226 443 286 934 843 866 90 260 173 513 243 279 650 560 462 492 922 471
752 331 854 235 690 850 727 844 697 342 781 572 114 654 880 506 168 453 501 993 377 65 95 204 706 179 186 825 270 513 876 408 140 324 943 991 95 366 813 58 855 295 678 751 529 615 362 548 909 976 414 867 509 257 434 586 922 958 396 870 740 849 38 681 958 807 683 838 662 104 652 705 605 646 213 321 192 384 247 188
499 151 270 763 32 116 771 722 834 424 511 994 25 255 53 533 700 572 370 719 229 717 679 961 869 868 471 706 710 618 577 134 451 707 150 306 726 158 476 176 762 873 948 890 360 448 492 352 45 589 109 710 767 747 569 0 502 190 262 868 502 135 816 847 111 772 941 418 698 647 43 713 464 457 335 341 256 792 546 849
457 113 940 557 560 494 577 39 502 515 973 108 74 223 606 821 510 859 863 937 715 257 1 354 936 723 887 723 681 166 81 152 748 326 460 328 915 53 675 628 292 735 175 634 511 952 299 85 582 222 790 928 681 141 698 910 654 436 804 193 233 450 164 212 968 155 172 304 63 334 906 542 10 216 779 891 218 185 486 488
263 320 765 832 526 755 185 690 701 108 156 269 381 285 322 364 420 243 627 966 469 102 391 470 706 34 762 917 8 442 164 162 243 403 679 824 246 999 276 840 243 303 458 21 126 461 981 945 31 700 389 538 893 553 801 441 295 57 786 361 545 83 297 171 54 34 497 351 7 63 813 957 757 712 891 887 252 268 326 282
113 567 417 456 456 763 586 901 742 25 699 710 75 567 419 176 936 244 521 249 808 588 213 531 744 637 80 138 536 891 754 662 364 908 189 589 974 830 534 360 904 215 707 395 271 564 105 720 344 670 396 542 133 240 699 401 925 922 222 859 554 207 323 743 291 220 469 745 55 606 329 500 775 669 835 102 874 301 434 243
301 946 453 614 611 39 166 263 390 665 83 965 791 312 625 748 879 309 642 218 793 231 1000 879 665 275 822 426 301 52 216 827 992 82 660 856 636 999 980 492 213 581 556 596 839 835 211 671 26 83 807 922 884 974 387 155 548 915 520 83 743 257 675 923 129 354 952 907 360 399 918 688 127 483 823 638 318 768 993 841
745 469 31 938 288 846 639 383 416 749 177 581 979 338 572 75 418 130 979 899 722 694 677 109 482 360 651 541 904 949 400 334 377 499 797 870 86 867 260 707 452 103 221 786 696 661 906 364 988 639 54 162 664 61 771 282 935 839 574 796 297 434 239 293 939 321 122 107 124 161 553 524 557 477 559 289 435 367 122 883
293 954 90 601 411 435 343 281 881 376 789 877 542 65 858 22 226 269 815 332 372 476 968 287 996 685 59 256 353 186 657 852 420 227 247 42 516 678 977 0 294 797 74 286 337 292 462 245 978 82 30 750 308 932 739 726 320 495 635 481 162 267 982 762 720 327 555 446 518 461 426 67 45 227 122 802 589 406 500 334
32 122 876 72 212 707 950 871 875 420 738 967 487 366 705 936 512 352 433 652 108 732 435 287 101 363 361 565 214 167 332 298 963 742 885 415 718 680 811 670 932 969 308 158 672 286 72 733 156 967 941 222 393 547 447 4 907 925 69 736 10 827 454 178 34 807 42 345 357 755 76 980 757 849 315 808 903 690 176 96
93 404 494 604 202 529 129 883 760 392 768 200 91 235 37 838 11 831 518 359 462 482 157 663 973 415 388 44 293 77 258 116 110 482 875 749 449 413 119 240 816 615 293 909 658 761 908 506 991 234 869 335 168 381 465 455 880 585 13 8 796 218 567 80 335 510 83 324 518 264 18 654 741 522 504 900 396 53 816 303
402 788 201 727 121 602 104 424 986 86 715 346 827 276 151 909 691 796 716 733 364 608 434 651 846 854 16 351 343 945 808 509 884 148 349 833 999 648 937 925 764 433 671 718 360 51 247 836 174 260 940 952 198 731 539 339 682 594 200 468 14 925 981 625 539 938 677 624 925 586 36 617 817 173 936 447 311 975 763 748
987 106 115 524 60 509 869 14 997 202 766 418 367 111 510 882 564 480 850 769 266 652 752 758 591 264 814 188 329 285 437 805 522 437 559 824 762 456 199 362 676 626 642 824 358 334 751 552 658 586 143 744 251 158 704 564 244 619 470 136 856 945 488 267 229 760 942 895 73 671 230 261 111 971 820 600 582 421 163 201
812 572 314 213 212 186 911 463 833 604 803 482 523 411 434 847 881 264 387 394 361 81 374 724 15 805 423 3 576 483 21 358 596 616 694 182 870 698 16 179 966 71 238 484 381 780 670 166 255 177 243 342 32 186 300 324 296 615 516 561 275 682 409 290 685 739 464 591 711 548 95 629 206 813 274 365 469 499 323 433
509 731 914 414 819 151 115 601 828 738 479 629 658 713 719 86 125 214 381 956 798 582 802 703 317 795 687 771 496 282 222 447 954 154 618 299 601 582 677 449 190 480 225 708 626 882 810 942 729 454 922 82 612 212 500 635 894 260 507 16 530 176 704 263 810 769 788 804 154 894 308 14 969 455 391 851 131 568 746 148
96 478 296 319 549 550 39 197 653 32 354 49 956 342 101 610 500 44 890 590 535 100 316 93 691 971 170 944 672 900 580 820 841 58 79 48 821 861 431 246 845 564 925 940 575 163 318 514 758 677 753 391 660 578 384 380 986 466 34 29 359 973 768 594 34 147 707 491 337 372 140 227 512 588 50 798 113 270 335 704
369 529 981 843 63 695 912 387 62 649 249 468 727 0 788 22 567 997 115 260 67 238 377 960 860 940 274 1 140 811 619 259 212 275 983 896 163 849 599 711 854 390 631 614 524 167 338 326 787 431 774 7 245 602 789 702 925 178 737 18 838 267 787 252 587 985 885 574 318 287 990 152 756 331 63 673 513 371 745 448
332 918 907 141 392 283 14 274 9 123 646 429 934 689 138 259 566 246 570 153 470 453 264 586 775 527 22 866 690 347 196 677 481 120 352 30 747 923 778 897 385 455 990 51 757 386 435 268 408 72 625 735 70 697 560 897 933 178 994 194 935 770 694 505 710 63 141 551 730 530 331 768 575 752 14 857 899 755 95 981
763 437 210 380 869 185 119 537 327 259 878 780 720 622 841 304 533 629 628 474 512 44 891 175 906 930 592 348 297 208 97 745 884 891 364 218 365 615 302 730 395 13 530 812 115 427 713 755 45 420 536 909 380 737 835 329 406 780 29 890 440 474 507 122 676 343 460 405 427 778 950 632 257 96 556 829 538 135 18 4
831 218 74 370 519 899 277 718 43 226 546 766 352 239 117 733 253 725 633 318 660 89 396 849 305 513 500 12 981 981 669 243 737 851 569 277 604 941 413 166 364 571 137 11 370 888 284 664 989 613 297 251 726 598 359 503 405 334 563 73 479 279 333 514 991 548 536 331 871 62 4 517 851 897 313 309 464 34 756 591
844 336 648 46 519 346 137 706 993 315 356 217 438 54 756 801 227 970 305 935 892 557 569 975 242 610 495 763 876 212 837 497 558 740 538 420 878 450 890 640 616 177 822 35 185 436 76 514 639 787 102 250 153 665 427 272 324 729 296 890 322 842 32 354 439 51 238 153 653 273 514 572 207 19 51 688 940 77 345 289
914 189 822 839 722 435 500 440 906 289 620 201 390 655 623 126 187 279 958 964 50 113 206 510 628 931 932 792 236 192 174 257 562 388 795 62 0 62 742 139 96 476 285 308 678 614 106 377 23 104 877 398 992 154 498 15 917 325 151 250 21 839 614 591 997 59 46 104 812 293 75 155 956 190 465 950 428 432 850 521
362 927 320 658 448 372 6 909 582 921 605 460 978 219 843 53 903 883 234 193 949 222 316 45 165 637 282 654 602 729 959 317 829 508 289 314 273 70 570 40 133 386 321 698 154 868 68 19 552 685 962 747 203 270 202 999 114 671 202 722 963 485 178 651 427 337 446 31 198 49 929 817 543 384 435 819 633 683 685 640
782 318 823 110 132 159 26 445 898 853 161 399 737 590 208 886 359 13 389 521 350 929 339 315 269 864 286 533 625 271 208 319 636 103 782 699 248 601 407 8 540 898 371 426 757 101 661 73 968 802 666 286 234 347 170 728 295 334 203 342 712 786 423 548 968 114 487 65 755 220 322 157 405 726 506 60 34 660 75 75
315 655 348 820 516 801 969 13 77 889 642 539 270 228 150 743 579 695 168 172 30 7 294 17 758 732 261 148 533 775 284 80 523 146 813 819 512 867 167 998 926 855 182 847 230 792 729 150 972 397 640 802 150 768 221 290 826 386 791 863 452 327 998 485 350 926 845 515 625 997 614 313 760 560 203 665 971 238 190 424
232 403 256 110 123 239 131 372 749 956 548 254 475 750 408 101 414 501 129 806 390 458 70 740 878 533 785 935 161 739 71 411 962 638 602 763 851 169 361 921 613 56 641 979 657 757 980 690 91 937 321 280 315 15 725 678 264 102 289 446 536 883 719 251 200 623 877 863 434 657 660 918 342 64 345 208 867 892 573 840
972 766 314 955 379 284 828 869 925 434 429 762 466 601 607 455 261 254 296 962 202 306 746 3 167 397 698 73 970 74 179 489 751 637 171 398 537 280 856 20 77 598 423 196 993 930 733 304 599 110 746 205 617 413 486 700 256 473 18 769 496 375 27 674 100 142 598 897 192 898 868 709 801 743 807 652 125 330 483 544
655 272 355 886 864 723 96 655 306 307 915 551 320 452 243 448 903 434 505 26 928 362 40 861 93 216 125 586 78 284 520 28 150 998 214 498 362 573 364 361 665 879 580 872 418 767 333 309 95 208 15 743 480 97 596 879 775 611 420 669 506 972 877 79 962 606 931 139 85 767 702 108 333 954 177 539 390 700 903 101
804 105 102 602 755 19 485 372 89 852 779 571 702 391 981 856 770 195 97 453 130 414 511 708 587 762 751 444 210 981 677 774 717 635 895 592 815 788 613 535 272 367 177 109 389 808 243 174 127 867 772 422 691 278 339 827 577 56 598 232 807 565 358 698 851 168 735 272 166 279 26 0 195 215 501 321 745 567 340 871
365 608 485 329 613 928 284 979 149 51 798 458 850 494 187 222 897 752 375 97 224 221 792 249 438 263 333 406 633 689 630 315 762 766 442 577 935 595 747 489 430 690 649 498 141 552 135 293 267 242 992 774 109 980 96 842 93 386 465 803 110 210 707 60 945 931 20 774 208 309 827 544 809 656 24 957 323 635 952 952
739 118 415 970 936 977 589 525 882 205 775 307 533 368 847 310 576 31 200 146 422 218 382 928 613 675 898 20 580 270 695 274 866 393 246 126 694 271 65 834 58 975 128 716 399 798 524 646 938 551 35 897 880 911 919 348 417 709 287 876 891 854 426 316 158 531 703 610 652 863 799 239 888 559 509 468 345 16 339 852
832 561 448 954 288 778 760 510 432 704 454 94 49 523 250 339 744 963 799 105 711 408 656 487 737 7 692 592 793 710 780 155 376 369 413 590 389 207 933 709 946 260 280 672 742 740 212 676 503 459 647 821 124 753 490 657 295 72 800 359 280 720 465 34 947 886 982 31 40 991 427 730 317 749 172 794 129 163 28 792
254 659 716 738 408 105 831 293 330 517 256 849 204 598 527 548 235 894 835 171 508 357 795 823 251 154 984 295 614 359 2 274 387 648 613 546 909 987 755 771 13 98 844 41 69 90 89 102 590 621 594 285 421 589 950 520 350 875 328 485 972 587 110 756 989 958 963 182 21 444 657 896 258 251 131 793 234 242 313 855
91 131 524 505 650 153 476 347 701 28 282 761 301 722 625 202 266 460 706 509 838 451 21 646 326 46 400 687 696 586 680 978 643 422 640 468 134 616 454 137 514 406 894 244 341 695 232 735 94 554 992 643 994 39 452 357 269 447 835 162 707 219 918 393 216 70 926 909 361 785 268 941 375 127 413 660 77 577 742 106
507 540 47 9 452 969 883 137 593 740 888 516 827 702 207 289 708 672 151 900 778 395 201 641 37 808 398 453 505 3 707 14 342 996 78 942 503 291 794 324 886 91 191 314 0 562 942 787 595 217 539 861 619 32 20 666 593 212 203 159 144 599 917 284 616 391 634 198 21 224 973 117 964 993 53 533 50 121 882 981
864 568 816 966 926 707 415 887 208 268 670 586 625 4 62 712 608 77 631 405 871 77 991 932 599 794 256 591 682 656 781 821 504 776 99 998 942 488 653 142 108 500 279 196 406 488 622 556 41 728 46 397 71 95 672 965 725 416 620 885 208 756 970 385 147 574 605 315 714 914 753 183 223 762 254 565 965 849 837 15
124 145 343 738 199 736 695 259 404 637 988 431 559 518 606 117 888 76 343 539 318 619 948 579 639 103 329 86 442 717 843 217 182 77 482 638 90 25 187 555 228 533 636 149 304 892 719 555 554 901 265 220 634 948 856 454 179 509 237 70 937 265 864 147 188 936 844 64 533 234 595 0 747 777 415 696 368 62 257 396
113 371 404 273 110 353 398 904 324 5 293 159 264 49 903 902 163 11 705 448 0 509 485 797 738 396 451 918 931 898 436 888 139 53 46 214 386 45 417 1000 531 318 283 484 592 143 995 508 280 864 432 950 437 606 249 157 67 501 956 147 955 944 532 526 10 252 298 813 405 189 287 900 455 89 873 149 389 710 946 28
98 429 85 494 825 373 400 76 819 837 564 338 102 817 513 665 933 550 855 272 127 380 963 648 810 570 405 171 641 760 648 517 47 552 193 465 786 681 105 142 450 324 772 829 486 102 798 219 715 516 844 624 802 228 803 141 12 262 570 121 156 743 150 36 651 410 331 30 613 384 614 580 158 139 438 181 26 141 39 344
34 682 104 831 789 692 741 344 986 982 88 301 11 191 404 261 761 799 692 66 776 93 877 63 980 240 70 549 258 829 231 252 923 254 827 508 253 31 966 971 58 6 280 442 673 152 760 68 639 475 191 439 489 475 281 862 794 518 699 730 79 798 463 357 597 783 766 889 193 192 289 808 306 95 448 852 968 242 145 861
729 934 89 162 393 117 898 47 106 877 158 845 373 656 25 223 570 209 286 684 587 233 728 930 121 269 579 820 493 409 627 124 617 467 718 706 713 417 557 644 91 658 420 57 534 171 312 379 702 415 132 421 141 451 60 293 217 364 397 311 291 394 149 355 25 16 668 497 33 829 81 301 140 294 639 186 584 791 118 207
879 943 163 625 599 279 271 914 895 142 709 538 759 438 79 313 865 792 207 812 180 823 196 914 153 324 497 142 461 553 461 791 942 95 327 799 934 564 215 913 400 496 115 281 518 359 822 90 632 532 196 886 928 524 920 470 115 672 56 320 652 151 957 399 995 302 499 629 508 893 845 689 387 176 963 306 705 515 529 256
566 430 523 876 826 55 71 527 878 694 326 819 711 337 363 891 499 203 172 6 213 663 726 41 135 937 444 682 221 223 105 928 80 749 50 40 956 656 411 862 487 941 943 454 225 724 175 143 905 916 867 540 827 694 930 640 197 311 693 372 505 942 891 427 493 863 471 450 206 811 791 237 625 310 633 432 712 581 840 472
133 71 702 983 982 973 901 301 928 467 897 426 587 862 71 963 132 269 301 408 96 9 27 29 766 798 478 623 724 542 601 575 326 777 544 133 546 570 640 249 35 478 449 759 287 17 173 608 343 835 940 600 273 470 853 318 109 458 337 256 52 881 540 306 872 328 796 483 710 141 760 942 333 738 41 184 698 842 379 731
600 502 936 675 922 116 840 546 566 72 756 89 367 216 863 408 619 26 205 225 464 953 774 217 797 783 787 729 375 845 960 964 495 873 378 954 448 74 149 851 825 829 415 685 896 773 661 134 420 971 138 2 16 253 72 338 514 16 347 297 776 787 808 68 102 670 472 222 456 622 95 638 727 804 882 26 193 628 857 125
872 417 828 506 59 748 414 576 965 25 208 994 671 907 943 920 140 872 982 850 735 444 738 867 397 453 5 999 499 344 837 726 884 758 721 546 398 113 106 364 933 711 940 558 959 546 418 656 406 648 244 972 373 245 26 88 516 412 876 637 748 441 283 779 69 95 700 217 195 520 731 446 381 856 475 931 955 575 661 387
